1111111111
1111000001
1000001111
1000000011
11C1000001
1111P00001
1000000001
1000000001
100000E001
1111111111
