111111
100011
100C01
100001
1P00E1
100E11
111111
