111111
110001
1P0001
100P01
1C0011
1000E1
111111
