111111
110001
1P1001
1oC001
1E1111
111111
