111111111111111111111111111111
1E0000000000000C00000C10000001
101001010010000010101110000011
101001001010101000100100000011
1P0000000C00C00000000000C00001
111111111111111111111111111111
