111111111111
100000000001
100P11000001
10001000C001
10C110000001
100010011001
100011100001
100010C00001
100000011001
100000C11001
1000000110E1
111111111111
