111111
100001
1P0C01
1000C1
100E01
111111
