111111
100011
1P0001
100E01
111111
