111111
110111
100C01
100P11
1C0001
111111
