111111
110011
1100C1
100001
100E01
111111
