1111111111
1111000001
11C1000001
1111P00001
100000E001
1111111111
