1111111111
1111000111
11C1100001
1111000011
1P110011C1
11E1111111
1111111111
